10000000000000001111
10000000000000000001
10000000000000000001
00000000000000000001
00000000000000000000
00000000000000000000
00000000101000000000
00000000000000000000
00000000000000000000
00000000000000000000
00000000000011111000
