11111111111111111111
12000000000000100051
10000000000000000001
10000000000000000001
10000000000000000001
10000000000000000001
10000000101000000001
10000000000000000001
10000000000000000001
13000000000000000041
11111111111111111111
